9
9
0 1
8 7
* *******
*     * *
* ***** *
* * *   *
* * *** *
*   *   *
*** * * *
*     * *
******* *
